---------------
---s-----------
----WWW--------
------W-S--HH--
------w----HH--
------www------
--HH----w------
--HH--S-W------
--------WWW----
-----------s---
---------------