---------------
-s-----------S-
---w-------w---
--ww-------ww--
-------H-------
-------H-------
-------H-------
--ww-------ww--
---w-------w---
-S-----------s-
---------------