-------w-------
-s-----------S-
---www---www---
-----wwwww-----
-----w---w-----
www--w---w--www
-----w---w-----
-----wwwww-----
---www---www---
-S-----------s-
-------w-------