---------------
---------------
---S-W---W-s---
--WWWW---WWWW--
---------------
---------------
---------------
--WWWW---WWWW--
---s-W---W-S---
---------------
---------------