-------H-------
-S-----H-----S-
------www------
--ww-------ww--
---H-------H---
---H-------H---
---H-------H---
--ww-------ww--
------www------
-s-----H-----s-
-------H-------