---------------
-s-----------S-
-----wwwww-----
--W---------W--
--W---------W--
--WHHH---HHHW--
--W---------W--
--W---------W--
-----wwwww-----
-S-----------s-
-------P-------