-------H-------
-----s-H-s-----
-------H-------
---WWWWWWWWW---
---------------
---------------
---------------
---WWWWWWWWW---
-------H-------
-----S-H-S-----
-------H-------