---------------
---------------
---------------
----WWWW-------
----W--WWWW-W--
----WP------W--
----W---WWWWW--
----WWWWW------
---------------
---------------
---------------