---------------
-------b-------
---------------
---------------
WWwwwWWWWWwwwWW
WWwwwWWWWWwwwWW
WWwwwWWWWWwwwWW
---------------
---------------
-P-------------
---------------