----H-----H----
----H--F--H----
----H-----H----
HHH---HHH---HHH
----H-----H----
----H-----H----
----H-----H----
HHH---HHH---HHH
----H-----H----
----H--P--H----
----H-----H----