---------------
-------F-------
---------------
---------------
------HHH------
------HHH------
------HHH------
---------------
---------------
---------------
-------P-------