-----------W---
-P---------W-b-
---WWwwwWWWW---
---W-----------
---W-b---------
---W---WWWWW---
-----------W---
-----------w---
WwwwWWW----w---
-----------w-F-
--b--------W---