---------------
-------------D-
--m--wwwwwww---
-----------w---
-------H-B-w---
WWWW---H---WWWW
---w-B-H-------
-P-w-----------
---wwwwwww--m--
---------------
---------------