WWWW-----------
WWWW-----P-----
WWWW-----------
WWWW---------T-
WWWW-T---------
WWWW-----T-----
WWWW-----------
WWWWWWWwwwwwWWW
WWWW-----------
WWWW---T---T---
WWWW-----------