---------------
---------------
----W----W-----
----W----W-----
---------w-----
--P------w--b--
---------w-----
----W----W-----
----W----W-----
---------------
---------------