-----m-F-m-----
---------------
-----wwwww-----
--W----b----W--
--W---------W--
--WHHH---HHHW--
--W---------W--
--W---------W--
-----wwwww-----
---------------
-------P-------