---------------
-M-------------
---------------
WWWHHWWWHHWWW--
---------------
-P-------------
---------------
WWWHHWWWHHWWW--
---------------
-M-------------
---------------