---------------
--m-------D----
----WWW--------
------W----HH--
------w----HH--
------www------
--HH----w---D--
--HH----W------
--------WWW----
-P-----------m-
---------------