---------------
-------------M-
---------------
-----W---WWHHHH
-----W---W-----
---B-W-P-W-B---
-----W---W-----
HHHHWW---W-----
---------------
-M-------------
---------------