---------------
-------------D-
--m--wwwwwww---
-----------w---
-------H-B-w---
wwww---H---wwww
---w-B-H-------
-P-w-----------
---wwwwwww--m--
---------------
---------------