WWWWWWWW-------
WWWWWW-------Z-
WWWW-------w---
WW---------ww--
-------H-------
-------H-------
-------H-------
--ww---------WW
---w-------WWWW
-P-------WWWWWW
-------WWWWWWWW