---------------
-F-W-------W---
--------W------
-----W-------B-
--W-------W----
-------P-------
----W-------W--
-B-------W-----
------W--------
---W-------W-F-
---------------