---------------
-------M-------
---WWW---WWW---
-M-W-------W-M-
---H-------H---
---H-------H---
---H---P---H---
---W-------W---
-M-WWWwwwWWW---
-------------M-
------M--------