---------------
-------M-------
-M-WWW---WWW---
---W-------W---
---H-------H---
---H-------H---
---H---P---H-M-
---W-------W---
---WWWwwwWWW---
--M------------
--------M------