-------H-------
-----P-H-Z-----
-------H-------
---WWWWWWWWW---
---------------
----M-----M----
---------------
---WWWWWWWWW---
-------H-------
-----Z-H-Z-----
-------H-------