---------------
-P-----------F-
---w-------w---
--ww-------ww--
-------H-------
-------H-------
-------H-------
--ww-------ww--
---w-------w---
-F-----------Z-
---------------