---------------
-------------M-
---WWWwwwWWW---
---------------
-------W-------
WWWW---W---WWWW
-------W-------
---------------
---WWWwwwWWW---
-P-------------
---------------