-------H-------
---F---H---B---
------www------
--ww-------ww--
---H-------H---
-Z-H-------H-P-
---H-------H---
--ww-------ww--
------www------
---F---H---B---
-------H-------