---W-----------
-b-W---------M-
---W----WWWW---
-----------W---
---------------
------www------
---------------
---W-----------
---WWWW----W---
-P---------W-b-
-----------W---