---------------
---------------
-----W---------
-----W-----W---
-----------W-F-
-P---------W---
-----------W-F-
-----W-----W---
-----W---------
---------------
---------------