-----------w---
-----------w---
-----------w---
---Wwww----W---
-D-W-------W---
---W-------W---
---W-------W-P-
---W----wwwW---
---w-----------
---w-----------
---w-----------