----H-----H----
-b--H-----H--M-
---------------
-HHHH-HHHHHHHHH
----H----------
----H-----H--b-
----------H----
HHHHHHHHH-HHHH-
----------H----
-P--H--M--H----
----H----------