-------w-------
-m-----------m-
---www---www---
-----wwwww-----
-----w---w-----
www--w-P-w--www
-----w---w-----
-----wwwww-----
---www---www---
-m-----------m-
-------w-------