WWWWWWWWWWWWWWW
WWWWWWWWWWWWWWW
-----------W---
-----------W-D-
---w-------w---
---w---P---w---
---w-------w---
-F-W-----------
---W-----------
WWWWWWWWWWWWWWW
WWWWWWWWWWWWWWW