-R--------b----
----b-WW-------
--b---WW-b-----
------------W--
--b---P------b-
--W--------b---
--WW-----WW----
-----b---WW--b-
--b----------WW
-WWWWW--------W
---------------