-R--------S----
----S-WW----R--
--S---WW-S-----
------------W--
--S---P------S-
R-W--------S---
--WW-----WW----
-----S---WW--S-
--S----------WW
-WWWWW-----R--W
---R-----------