------P--------
----W---ww-----
--WWW---ww-W---
----WW-----WWW-
--H------WW----
------H---W----
--WWWW---------
-WW----------WW
--W----WWW-----
---------W-----
---------------