-----P---------
-------W-------
WWWWWWWW-------
---W------WWW--
---W---WWW-----
--WW-----W-----
--WW--W--WW----
-----WW--WW----
-----W-------WW
-WWWWW---W----W
M--------W-----