----WP---------
----W----------
--WWW------W---
----WW-----WWWW
-SS----R-WW----
----------W-SS-
--WWWW---------
WWW----------WW
--W----WWW-----
---------W-----
M--------W-----