----W-P--------
----W----------
--WWW------W---
----WW-----WWWW
---------WW----
----------W----
--WWWW---------
WWW----------WW
--W----WWW-----
---------W-----
---------W-----