---------------
-------W-----r-
---W-------W---
------HHH------
-----H---H-----
--W--H-P-H--W--
-----H---H-----
------HHH------
---W-------W---
-r-----W-------
---------------