---------------
m-m-m-m-m-m-m-m
---------------
m-m-m-m-m-m-m-m
---------------
-m-m-m-P-m-m-m-
---------------
m-m-m-m-m-m-m-m
---------------
m-m-m-m-m-m-m-m
---------------