MW-----------W-
-W-----------WM
MW-WWW---WWW-W-
-W-W-------W-WM
MW-H-------H-W-
-W-H-------H-WM
MW-H---P---H-W-
-W-W-------W-WM
MW-WWWwwwWWW-W-
-W-----------WM
---------------